1111111111111111111111111111111111111
1E00100000000000000010000000100000101
1010101110111111111010101110101010101
1010101000100000001010101000101010101
1011101011101111101011101011111010101
1010001000000010001000001000100010001
1010111111111110111111111110101111101
100010001000001000100010000B001000101
1011101010111011101010111111111010101
1010001010100000100010100000100010101
1010111010111110111110101110101111101
1010001010000010100010101010101000101
1011101011111010101010101010101010101
1000101010000010001010100010100010101
1110101010111111111010111010111110101
1010101010100010100010001010000010101
1010111010101010101111101011111010101
1010000010101000101000100000001010001
1011111010101111101010111111101010111
1000100010100000100010100000101010101
1010101110111110111110101110111010101
1010001010000010000010100010001010001
1111111011111011101110111011101011101
1000000010001000100010B01010101000101
1011111110101110101011101010101110101
10000000001000001010000000100000001S1
1111111111111111111111111111111111111

