1111111111111111111111111111111111111
1E000B0000000010000000001000100000001
1011101111111010111111101010101111101
1000100000100010000000100010101010001
1011111110101111111110111111101010111
1010001B00101000100000100000001000001
1110101011101010101111111011111111111
1000100010101010100000001000000000001
10111111101010101111111011111011111B1
101010000000101B000000100000100010101
10101011111111101011111111101110101B1
1010000010B00010100000000010001010101
10111110111010111111111B11111010101B1
1000100000001010001000001000001010101
1010101111111010101011101011111010101
1010101010001010101000101000B01010101
1110101010101010101110101111101010101
1000101010101000100010101000001000101
1011101010101111111010101011111110101
1000100010100010000010101010000010101
1010111110111010111110101011101011101
1010100000100010100000101000001000001
1010101111101110101111111111111111101
1010101000100010001000000000000000101
1010101010111011111011111110111111101
10100000100010000000000000100000000S1
1111111111111111111111111111111111111

