1111111111111111111111111111111111111
1E00000010000010000000000000100000001
10111B1010111010111111101111101011101
1010101000100B10100000100000001000101
1110101111101110101011111111111110101
1000100000101000101000000000100010101
1011111110101011101111101110111010111
101000100010101000100B001010000010001
1010101011101011111011111011111011101
1010101000100000000010100000000000101
1010101011111110111110101111111111101
1010100010001000100010100000001000001
1011111110101111101010111011111011101
1000000000100000001010001010001000101
1111111111111111111011101010101110101
1000000000001000001000100010100000101
1011111110111011101110111110111111101
1010000000100010000010000000100010001
1011111111101110111111111111101010111
1000000010001010000000100000001010101
1011111010111011111110101110111110101
1000001010100000100010001000100000101
1111101010101110101111111010101111101
1000101010001010100000100010101000001
1010101011111010111110101111101011101
10100010000000000000001000000000100S1
1111111111111111111111111111111111111

