1111111111111111111111111111111111111
1E000010000010000000B0000010000000001
1010101011101011111011111110111011101
1010101000101000001000100000B01010001
101011101110111110111B101111111010111
1010000010000010000010000000100010001
1011111110111110111111111111101111111
1000101000100010100000100000100000001
1110101010101010101110101110111011101
1000101010101000100010101010001000101
1011101011101111111010101011101110101
1000001000001000000010001000100010101
1111101111111011111111111010111011101
1000100010000010000000001010001010001
1011111010111111111111101010111010111
1000001010000000000000100010001010001
1111101011111111111010101111101011101
1000001000001000001010101000100010001
1011111111101011111010101010111110111
1010000000001000101010101010100010001
1010111111111110101010101010101011101
1000100000001000100010100010001010001
1011111010101011111110111111111010111
1010001010101010000010001000001010001
1010101110101011101011101010111011101
10001000001010000010000010100000000S1
1111111111111111111111111111111111111

