1111111111111111111111111111111111111
1E0000001000100000100000100B000010001
1011111010101011101110101011111011101
1000001010101010000000101000100000101
1111101010101011111111101110111110101
10100010001010000010001B0010001010101
1010111111101110101110111011101010101
1010001000100010100010001000001010101
1011101010111110111011101111111010101
1000001010100010100010001000001000101
1011111010101011101110111010111011101
100010001000100000100010B010001000101
1110101111111111111010101111101110101
1010100010000000101010001000100010101
1010101010111110101011111010111010101
1010101000100000100010001010100010101
1010111111101111101110111010101110101
1010000000001000001000001010101000101
1011111111111011111111101010101011101
1000000000001010000000001010001010001
1011101111101010101111111011111010111
1010101000001000101000100010000010001
1010101110111110111010101110111111101
1000100010001000100010001000100000101
1110111011111011101111111011101110101
10000010000000001000000000000010000S1
1111111111111111111111111111111111111

