1111111111111111111111111111111111111
1E00100000100010000000001000000000001
1010101110101010111110111011111110101
101000101010101010000010B010100000101
1011111010101010101111101110101111101
1000100010001000100000001000100000101
1110101111111111111111111011111110101
1010100000000000000010000000000010101
1010101111111111101110111110111010101
10101010B0000000100000100010100010101
1010111011111110111011111010111110111
1010000010000010001000000010100010001
1011111111111011101011111010101011101
1000100000001010001010001010001010001
1110101110101010111110101111111010101
1000100010100010000010100010000010101
1011111010111111111010111010111010111
10100000101000000B1010001000101010001
1010111110101011101011101111101011101
1000100010101010001000001000101010001
1011111010101011101111101110101010111
1000001010001000101000000010100010001
1111101011111110111011111110101111101
1000101000100010000010001000100000101
1011101010101011111110101011111111101
10000000100010000000001010000000000S1
1111111111111111111111111111111111111

