1111111111111111111111111111111111111
1E1000B0000B00000000B00010000B0000101
10101111111111101110111B1011101110101
1010100B00B00B10B010100B10001000101B1
10101B111111101111101011111110101B1B1
101B10100BBB10B00010101B0B00101010001
1B101B1110111111101010101110111011101
10001000100000B010101000101B0B101B001
10111110101B11101B1011111011101010111
10101B0010101010101010000010B01010001
1B101011101B101B1B1010111110111011101
1B10101B001B10001B0B1B1000001B0010001
10101011111011111111101B11111B1010111
100B101B001010000010001010000010100B1
1110101010101011101010101011111011101
10101000101B001010001B1B1010001000101
101B1111101B1110111110101B11101110111
101010B00010BB00000B10101000000B10001
1B101011101111111110101B1111101111101
101010B010100010000010101000001B000B1
1010111B1110101111111B101011111011111
1B10101010001000000010B0101BBB10000B1
101010101B111111111110111010101111101
100B1010100B100000B0101B00101BB010BB1
101110101110101111111B111110111010101
10000010000010000000000000001000001S1
1111111111111111111111111111111111111

