1111111111111111111111111111111111111
1E00000000100000001000000000001000001
1011111011101111101011111110101011101
101000101000101000101000100010B010001
1010101010111011111010101011101111111
1010100010000010100010101000101000001
1011111111111010101110101110111011101
1000000000001010100010100010000010001
1011111110111B10111010111010111110111
100010B010001010100010100010000010001
1110101011101010101110101111111011101
1010101000100010100010100000100010001
1010101011111110111010111110101110101
1000101000000000000010100010101000101
1011101111111111111110111010111011101
1010001000100000000000100010100010001
1010111011101111111111101110101111111
1010000010001000001000000010100000001
1011111010111010101011111010101111101
1010001010100010101010000010100000101
1010111010111110101110111010111111101
1010000010100000100010100010100000001
1011111110101111111010111110101111101
1000001000100000001000100000101000101
1111101011101111101111101111101011101
10000000100000001000000000000010000S1
1111111111111111111111111111111111111

