1111111111111111111111111111111111111
1E00001000001000001000000000100000B01
101110101110101B101010111110101011101
1000100000100010101010100010101010101
1111111011111110101010111010111010101
10000010100B0000101010001010000010101
1011101010111111101010111011111110101
1010001010001000001010100010100000101
1011101111101111111010101110101110101
10001B100010000010001010B010001000101
101010101011111010111011101B111011101
10101010100000001010000010101010100B1
1110101011111110101111101010101010111
1000101000001010101000101010001010001
1011101011101010101010111011101011101
1000101010001000100010000010001000101
1110101110111011111111111110111011101
100010000010001B000000100000101000001
1010111111111110111010101111101111111
1010100000100000100010101000000010B01
1011101110101111101111101111101011101
1010001010001000101000100010001010001
1010111011111010101010111010111010101
1000100000001010001010001000101000101
1011111110101011111011101111101111101
10000000001010000000001000000000000S1
1111111111111111111111111111111111111

