1111111111111111111111111111111111111
1E100B0000000000000000001000100000001
1010111111111110111110101011101011101
1010100000000010000010100010001010101
1010101111111011101110111110111010101
100010100010001000100B100000100010001
1011101110101111111010101111101110111
1000100010100000000010100010101000001
1110111010111110111111111010101111111
1000001010000010100000000000101000001
1111101010101110101111111111101011101
1000101010101000101000000010001000101
1010111010111011101011111010111011101
101000001000000010B010001010000010001
1011111111111110101110101111111110111
1000000010000010101000100000000010001
1011111010111011101011111111111011101
1010001000100010001000100000001000101
1010101111101110111110111110111110101
1000100000101000100010100010000010001
1111111011101011101010101011101011101
1000000010001010001010001000101010001
1011111110101010111011111110101110111
1010000010101010001010100000100010001
1011111010111011101010101111101011101
10000000100000000010001000100010000S1
1111111111111111111111111111111111111

