1111111111111111111111111111111111111
1E000000B0000010001000000010001000001
1011111110111110101110111011101010101
1000001000100000101000101000101010101
1011101111101111101011101110101010101
1010001000100010101010B00010100010101
1110111010111010101B11101010101110111
1000100010100010101000101000100010001
1011101111101110101110101111111110101
1010001000001000101000101000000010101
1010111011111110101011101011101010101
1010100010000000100010001010001010101
1010101110101011111110111010111010101
1010001010101010000000100010001010101
1011111010101110111111111111101011101
1000100000100010000000100000001000001
1010101111111011111110101111111111101
1010001000001000001010001010000000101
1011111011101011101011111010111011101
1010001010000010000000100000101000001
1011101011111110111111101111101111111
1010001000001000100010001000001000001
1010101111101011101010111110101011101
1010101000101010001010100000100010101
1010101010101110111010101111111110101
10001000101000000010000010000000000S1
1111111111111111111111111111111111111

