1111111111111111111111111111111111111
1E10000000000000000000000000100000001
1010111111111110111111111110101111101
1000101000100010000010000000101000101
1011101010101011111110101111101010101
1010000010101000000010101000001010101
1011111110101111111010101011111110101
10100000001B1000001000101010000010101
1010111111101011101110111010101010101
1000100000101000100010100010101010101
11111B1110101110111011101111101010101
1000000010100010001000101000001010101
1011111110101111101110101110111010101
1010001000100000100010100B00100000101
1010101011101110101110111111101111101
1010101010000010101000100010001000001
1011101011111010101011101010111011101
1000101010001010001000001010001010001
1110101010101011111011111011101011101
1010001000101010001000101B10001000101
10111011111010101011101B1010111110101
1010001000001010101010001000000010101
1010111011111110101011101111111110101
1000101010000010101000000000100000101
1011101111101010101111111111101111101
10000000000010001000000000000010000S1
1111111111111111111111111111111111111

